NO sprites/north.xpm
SO sprites/south.xpm
WE sprites/west.xpm
EA sprites/east.xpm

F 20,20,20
C 200,200,200


1111
10001
1001
10001
10001111
10001S01
110011111111
10001
10001
10001
10001
100 1
11111


